astrazeneca =enoun =медкомпания =компания
бог =бог =сущ.мр
брат =брат =человек =сущ.мр
вечер =вечер =сущ.мр
взгляд =взгляд =сущ.мр
вид =вид =сущ.мр
власть =власть =сущ.жр
внимание =внимание =сущ.ср
вода =вода =сущ.жр
воздух =воздух =сущ.мр
война =война =сущ.жр
вопрос =вопрос =сущ.мр
время =время =сущ.ср
генерал =генерал =человек =сущ.мр
глаз =глаз =частьтела =сущ.мр
год =год =время =сущ.мр
голова =голова =частьтела =сущ.жр
голос =голос =сущ.мр
город =город =сущ.мр
дверь =дверь =сущ.жр
девушка =девушка =человек =сущ.жр
дело =дело =сущ.ср
день =день =время =сущ.мр
дом =дом =недвижимость =сущ.мр
дорога =дорога =сущ.жр
друг =друг =человек =сущ.мр
душа =душа =сущ.жр
жена =жена =человек =сущ.жр
женщина =женщина =человек =сущ.жр
жизнь =жизнь =сущ.жр
земля =земля =планета =сущ.жр
имя =имя =сущ.ср
история =история =сущ.жр
квартира =квартира =недвижимость =сущ.жр
книга =книга =сущ.жр
комната =комната =сущ.жр
конец =конец =сущ.мр
кровь =кровь =сущ.жр
лес =лес =сущ.мр
лицо =лицо =частьтела =сущ.ср
мальчик =мальчик =человек =сущ.мр
мама =мама =человек =сущ.жр
мать =мать =человек =сущ.жр
машина =машина =авто =сущ.жр
место =место =сущ.ср
месяц =месяц =время =сущ.мр
минута =минута =время =сущ.жр
мир =мир =сущ.мр
москва =москва =город =россия =сущ.жр
мысль =мысль =сущ.жр
народ =народ =люди =сущ.мр
начальник =начальник =человек =сущ.мр
небо =небо =сущ.ср
нога =нога =частьтела =сущ.жр
образ =образ =сущ.мр
окно =окно =сущ.ср
отец =отец =человек =сущ.мр
отношение =отношение =сущ.ср
палец =палец =частьтела =сущ.мр
письмо =письмо =сущ.ср
плечо =плечо =частьтела =сущ.ср
пол =пол =сущ.мр
пора =пора =сущ.жр
правда =правда =сущ.жр
право =право =сущ.ср
путь =путь =сущ.мр
работа =работа =сущ.жр
раз =раз =сущ.мр
разговор =разговор =сущ.мр
ребенок =ребенок =сущ.мр
россия =россия =страна =сущ.жр
рука =рука =частьтела =сущ.жр
ряд =ряд =сущ.мр
свет =свет =сущ.мр
сердце =сердце =частьтела =сущ.ср
сила =сила =сущ.жр
система =система =сущ.жр
слово =слово =сущ.ср
случай =случай =сущ.мр
смерть =смерт =сущ.жр
солдат =солдат =человек =сущ.мр
спина =спина =частьтела =сущ.жр
старик =старик =человек =сущ.мр
стена =стена =сущ.жр
стол =стол =мебель =сущ.мр
сторона =сторона =сущ.жр
страна =страна =сущ.жр
сын =сын =человек =сущ.мр
тело =тело =сущ.ср
товарищ =товарищ =человек =сущ.мр
труд =труд =сущ.мр
тысяча =тысяча =число =сущ.жр
улица =улица =сущ.жр
утро =утро =время =сущ.ср
хозяин =хозяин =человек =сущ.мр
час =час =время =сущ.мр
часть =часть =сущ.жр
шаг =шаг =сущ.мр
школа =школа =сущ.жр
язык =язык =частьтела =сущ.мр
